@&@@@@@@#@
@________@
@_@___@@_@
@_@____@_@
@________@
@@@______@
@________@
@____@@@@@
@________@
@________@
@________@
@@_______@
@@@______@
@@_______@
@________@
@________@
@@@@@@@@@@