          
          
          
          
          
          
   @@@@@@@
   @_____@
   @____w@
   @_____@
   @_____@
   @@@@__@
   @_____@
   @_____@
   @_____@
   @_____@
   @@@@*@@