          
          
          
          
          
          
@@@@@@@@@@
@________@
@________@
@______d_@
@________@
@______cs@
@________@
@______b_@
@________@
@________@
@@*@@@@@@@